18 18
710 65 
1 2 2 2 1 2 2 2 2 2 2 2 1 2 2 2 2 1
3 0 0 4 3 4 0 1 0 4 0 0 3 0 4 4 0 3
1 2 1 0 3 0 0 3 0 0 0 4 3 0 0 0 0 3
3 0 3 0 3 0 0 1 2 2 1 0 3 0 0 0 0 3
3 0 3 0 1 1 0 0 0 0 0 0 3 0 1 1 0 3
3 0 3 0 1 0 0 0 1 2 1 0 3 0 3 3 0 3
3 0 3 4 0 0 0 4 3 0 3 4 3 4 3 3 4 3
3 0 1 2 2 2 2 2 1 0 3 0 3 0 3 3 0 3
3 0 0 0 0 0 0 0 0 0 3 0 3 0 1 1 0 3
1 2 1 2 2 2 2 2 2 2 1 0 3 0 0 0 4 3
3 0 3 4 4 4 0 0 0 0 0 4 3 0 0 0 0 3
3 0 1 2 2 2 2 2 2 2 1 0 1 2 2 1 0 3
3 0 4 0 0 0 0 0 4 0 3 0 3 0 0 0 0 3
3 0 0 1 2 1 0 0 0 0 1 0 3 0 4 0 0 3
3 0 0 3 0 3 0 0 0 0 0 0 3 0 1 2 2 1
3 0 4 1 2 1 0 0 0 0 1 0 1 0 0 0 0 3
3 0 0 0 0 4 0 0 4 0 3 4 0 0 0 0 4 3
1 2 2 2 2 2 2 2 2 2 1 2 2 2 2 2 2 1